<access_modifier>	<access_modifier>
<class>	<class>
<program_name>	<program_name>
<end_program>	<end_program>
ε	ε
<end>	<end>
<end_if>	<end_if>
<end_while>	<end_while>
<data_type>	<data_type>
<identifier>	<identifier>
<scanner>	<scanner>
<print>	<print>
<if>	<if>
<until>	<until>
<logical_operator>	<logical_operator>
<relational_operator>	<relational_operator>
<assign>	<assign>
<string>	<string>
<number>	<number>
<character>	<character>
<boolean_value>	<boolean_value>
<operator>	<operator>
<program>	<access_modifier>
<statement_list'>	ε, <access_modifier>, <print>, <until>, <data_type>, <if>, <identifier>, <string>, <number>, <character>, <boolean_value>
<declaration>	<access_modifier>
<input>	<data_type>
<output>	<print>
<if_statement>	<if>
<while_statement>	<until>
<condition'>	<relational_operator>
condition'>	ε
<assignment>	<assign>
<term>	<identifier>, <string>, <number>, <character>, <boolean_value>
<constant>	<string>, <number>, <character>, <boolean_value>
<statement>	<access_modifier>, <print>, <until>, <data_type>, <if>, <identifier>, <string>, <number>, <character>, <boolean_value>
<condition>	<identifier>, <string>, <number>, <character>, <boolean_value>
<math_expression>	<identifier>, <string>, <number>, <character>, <boolean_value>
<expression>	<identifier>, <string>, <number>, <character>, <boolean_value>
<relational_expression>	<identifier>, <string>, <number>, <character>, <boolean_value>
<statement_list>	<access_modifier>, <print>, <until>, <data_type>, <if>, <identifier>, <string>, <number>, <character>, <boolean_value>
